##########
#........#
#######..#
#.....#..#
#.....#..#
#.#####..#
#........#
#..####..#
#..#.....#
##########